ἀμφιβάλλω|ἀμφί+βάλλω
ἀναβαίνω|ἀνά+βαίνω
ἀναβάλλομαι|ἀνά+βάλλομαι
ἀναβιβάζω|ἀνά+βιβάζω
ἀναβλέπω|ἀνά+βλέπω
ἀναβοάω|ἀνά+βοάω
ἀναγγέλλω|ἀνά+ἀγγέλλω
ἀναγεννάω|ἀνά+γεννάω
ἀναγινώσκω|ἀνά+γινώσκω
ἀναγνωρίζομαι|ἀνά+γνωρίζομαι
ἀνάγω|ἀνά+ἄγω
ἀναδείκνυμι|ἀνά+δείκνυμι
ἀναδέχομαι|ἀνά+δέχομαι
ἀναδίδωμι|ἀνά+δίδωμι
ἀναζάω|ἀνά+ζάω
ἀναζητέω|ἀνά+ζητέω
ἀναζώννυμι|ἀνά+ζώννυμι
ἀναζωπυρέω|ἀνά+ζωπυρέω
ἀναθάλλω|ἀνά+θάλλω
ἀναθεματίζω|ἀνά+θεματίζω
ἀναθεωρέω|ἀνά+θεωρέω
ἀναιρέω|ἀνά+αἱρέω
ἀνακαθίζω|ἀνά+κατά+ἵζω
ἀνακαινίζω|ἀνά+καινίζω
ἀνακαινόω|ἀνά+καινόω
ἀνακαλύπτω|ἀνά+καλύτω
ἀνακάμπτω|ἀνά+κάμπτω
ἀνάκειμαι|ἀνά+κεῖμαι
ἀνακεφαλαιόω|ἀνά+κεφάλαιον
ἀνακλίνω|ἀνά+κλίνω
ἀνακράζω|ἀνά+κράζω
ἀνακρίνω|ἀνά+κρίνω
ἀνακύπτω|ἀνά+κύπτω
ἀναλαμβάνω|ἀνά+λαμβάνω
ἀναλίσκω|ἀνά+ἁλίσκω
ἀναλογίζομαι|ἀνά+λογίζομαι
ἀναλύω|ἀνά+λύω
ἀναμένω|ἀνά+μένω
ἀναμιμνῄσκω|ἀνά+μιμνῄσκω
ἀνανεόω|ἀνά+νεόω
ἀνανήφω|ἀνά+νήφω
ἀναπαύω|ἀνά+παύω
ἀναπείθω|ἀνά+πείθω
ἀναπέμπω|ἀνά+πέμπω
ἀναπηδάω|ἀνά+πηδάω
ἀναπίπτω|ἀνά+πέμπω
ἀναπληρόω|ἀνά+πληρόω
ἀναπτύσσω|ἀνά+πτύσσω
ἀνάπτω|ἀνά+ἄπτω
ἀνασείω|ἀνά+σείω
ἀνασκευάζω|ἀνά+σκευάζω
ἀνασπάω|ἀνά+σπάω
ἀναστατόω|ἀνά+στατόω
ἀνασταυρόω|ἀνά+σταυρόω
ἀναστενάζω|ἀνά+στενάζω
ἀναστρέφω|ἀνά+στρέφω
ἀνατάσσομαι|ἀνά+τάσσομαι
ἀνατέλλω|ἀνά+τέλλω
ἀνατίθεμαι|ἀνά+τίθεμαι
ἀνατρέπω|ἀνά+τρέπω
ἀνατρέφω|ἀνά+τρέφω
ἀναφαίνω|ἀνά+φαίνω
ἀναφέρω|ἀνά+φέρω
ἀναφωνέω|ἀνά+φωνέω
ἀναχωρέω|ἀνά+χωρέω
ἀναψύχω|ἀνά+ψύχω
ἀνέρχομαι|ἀνά+ἔρχομαι
ἀνετάζω|ἀνά+ἐτάζω
ἀνευρίσκω|ἀνά+εὑρίσκω
ἀνέχομαι|ἀνά+ἔχομαι
ἀνήκω|ἀνά+ἥκω
ἀνίημι|ἀνά+ἵημι
ἀνίστημι|ἀνά+ἵστημι
ἀνοίγω|ἀνά+οἴγω
ἀνοικοδομέω|ἀνά+οἰκοδομέω
ἀνορθόω|ἀνά+ὀρθόω
ἀνθίστημι|ἀντί+ἵστημι
ἀνθομολογέομαι|ἀντί+ὁμολογέω
ἀνταγωνίζομαι|ἀντί+ἀγωνίζομαι
ἀνταναπληρόω|ἀντί+ἀνά+πληρόω
ἀνταποδίδωμι|ἀντί+ἀπό+δίδωμι
ἀνταποκρίνομαι|ἀντί+ἀπό+κρίνομαι
ἀντέχομαι|ἀντί+ἔχομαι
ἀντιβάλλω|ἀντί+βάλλω
ἀντιδιατίθεμαι|ἀντί+διά+τίθεμαι
ἀντικαθίστημι|ἀντί+κατά+ἵστημι
ἀντικαλέω|ἀντί+καλέω
ἀντίκειμαι|ἀντί+κεῖμαι
ἀντιλαμβάνομαι|ἀντί+λαμβάνομαι
ἀντιλέγω|ἀντί+λέγω
ἀντιλοιδορέω|ἀντί+λοιδορέω
ἀντιμετρέω|ἀντί+μετρέω
ἀντιπαρέρχομαι|ἀντί+παρά+ἔρχομαι
ἀντιπίπτω|ἀντί+πίπτω
ἀντιστρατεύομαι|ἀντί+στρατεύομαι
ἀντιτάσσομαι|ἀντί+τάσσομαι
ἀντοφθαλμέω|ἀντί+ὀφθαλμός
ἀπαγγέλλω|ἀπό+ἀγγέλλω
ἀπάγχομαι|ἀπό+ἄγχομαι
ἀπάγω|ἀπό+ἄγω
ἀπαίρω|ἀπό+αἴρω
ἀπαιτέω|ἀπό+αἰτέω
ἀπαλγέω|ἀπό+ἀλγέω
ἀπαλλάσσω|ἀπό+ἀλλάσσω
ἀπαλλοτριόομαι|ἀπό+ἀλλοτριόομαι
ἀπαντάω|ἀπό+ἀντάω
ἀπεῖπον|ἀπό+εἶπον
ἀπεκδέχομαι|ἀπό+ἐκ+δέχομαι
ἀπεκδύομαι|ἀπό+ἐκ+δύω
ἀπελαύνω|ἀπό+ἐλαύνω
ἀπελπίζω|ἀπό+ἐλπίζω
ἀπέρχομαι|ἀπό+ἔρχομαι
ἀπέχω|ἀπό+ἔχω
ἀποβαίνω|ἀπό+βαίνω
ἀποβάλλω|ἀπό+βάλλω
ἀποβλέπω|ἀπό+βλέπω
ἀπογίνομαι|ἀπό+γίνομαι
ἀπογράφω|ἀπό+γράφω
ἀποδείκνυμι|ἀπό+δείκνυμι
ἀποδεκατόω|ἀπό+δεκατόω
ἀποδέχομαι|ἀπό+δέχομαι
ἀποδημέω|ἀπό+δημέω
ἀποδίδωμι|ἀπό+δίδωμι
ἀποδιορίζω|ἀπό+διορίζω
ἀποδοκιμάζω|ἀπό+δοκιμάζω
ἀποθησαυρίζω|ἀπό+θησαυρίζω
ἀποθλίβω|ἀπό+θλίβω
ἀποθνῄσκω|ἀπό+θνῄσκω
ἀποκαθίστημι|ἀπό+κατά+ἵστημι
ἀποκαλύπτω|ἀπό+καλύπτω
ἀποκαταλλάσσω|ἀπό+κατά+ἀλλάσσω
ἀπόκειμαι|ἀπό+κεῖμαι
ἀποκεφαλίζω|ἀπό+κεφαλίζω
ἀποκλείω|ἀπό+κλείω
ἀποκόπτω|ἀπό+κόπτω
ἀποκρίνομαι|ἀπό+κρίνομαι
ἀποκρύπτω|ἀπό+κρύπτω
ἀποκτείνω|ἀπό+κτείνω
ἀποκυλίω|ἀπό+κυλίω
ἀπολαμβάνω|ἀπό+λαμβάνω
ἀπολείπω|ἀπό+λείπω
ἀπόλλυμι|ἀπό+ὄλλυμι
ἀπολογέομαι|ἀπό+λόγος
ἀπολούομαι|ἀπό+λούομαι
ἀπολύω|ἀπό+λύω
ἀπομάσσομαι|ἀπό+μάσσομαι
ἀπονέμω|ἀπό+νέμω
ἀπονίπτω|ἀπό+νίπτω
ἀποπίπτω|ἀπό+πίπτω
ἀποπλανάω|ἀπό+πλανάω
ἀποπλέω|ἀπό+πλέω
ἀποπνίγω|ἀπό+πνίγω
ἀπορίπτω|ἀπό+ῥίπτω
ἀπορφανίζω|ἀπό+ὀρφανός
ἀποσπάω|ἀπό+σπάω
ἀποστεγάζω|ἀπό+στεγάζω
ἀποστέλλω|ἀπό+στέλλω
ἀποστερέω|ἀπό+στερέω
ἀποστοματίζω|ἀπό+στοματίζω
ἀποστρέφω|ἀπό+στρέφω
ἀποστυγέω|ἀπό+στυγέω
ἀποτάσσομαι|ἀπό+τάσσομαι
ἀποτελέω|ἀπό+τελέω
ἀποτίθημι|ἀπό+τίθημι
ἀποτινάσσω|ἀπό+τινάσσω
ἀποτίνω|ἀπό+τίνω
ἀποτολμάω|ἀπό+τολμάω
ἀποτρέπομαι|ἀπό+τρέπομαι
ἀποφέρω|ἀπό+φέρω
ἀποφεύγω|ἀπό+φεύγω
ἀποφθέγγομαι|ἀπό+φθέγγομαι
ἀποφορτίζομαι|ἀπό+φορτίζομαι
ἀποχωρέω|ἀπό+χωρέω
ἀποχωρίζομαι|ἀπό+χωρίζομαι
ἀποψύχω|ἀπό+ψυχή
ἀπωθέομαι|ἀπό+ὠθέομαι
ἀφαιρέω|ἀπό+αἱρέω
ἀφίημι|ἀπό+ἵημι
ἀφικνέομαι|ἀπό+ἱκνέομαι
ἀφίσταμαι|ἀπό+ἵσταμαι
ἀφομοιόω|ἀπό+ὁμοιόω
ἀφοράω|ἀπό+ὁράω
ἀφορίζω|ἀπό+ὁρίζω
ἀφυπνόω|ἀπό+ὑπνόω
ἀφυστερέω|ἀπό+ὑστερέω
διαβαίνω|διά+βαίνω
διαβάλλω|διά+βάλλω
διαβεβαιόομαι|διά+βεβαιόομαι
διαβλέπω|διά+βλέπω
διαγγέλλω|διά+ἀγγέλλω
διαγίνομαι|διά+γίνομαι
διαγινώσκω|διά+γινώσκω
διαγογγύζω|διά+γογγύζω
διαγρηγορέω|διά+γρηγορέω
διάγω|διά+ἄγω
διαδέχομαι|διά+δέχομαι
διαδίδωμι|διά+δίδωμι
διαζώννυμι|διά+ζώννυμι
διαιρέω|διά+αἱρέω
διακαθαίρω|διά+καθαίρω
διακαθαρίζω|διά+καθαρίζω
διακατελέγχομαι|διά+κατά+ἐλέγχω
διακούω|διά+ἀκούω
διακρίνω|διά+κρίνω
διακωλύω|διά+κωλύω
διαλαλέω|διά+λαλέω
διαλέγομαι|διά+λέγω
διαλείπω|διά+λείπω
διαλλάσσομαι|διά+ἀλλάσσομαι
διαλογίζομαι|διά+λογίζομαι
διαλύω|διά+λύω
διαμαρτύρομαι|διά+μαρτύρομαι
διαμάχομαι|διά+μάχομαι
διαμένω|διά+μένω
διαμερίζω|διά+μερίζω
διανέμω|διά+νέμω
διανεύω|διά+νεύω
διανοίγω|διά+ἀνά+οἴγω
διανυκτερεύω|διά+νυκτερεύω
διανύω|διά+ἀνύω
διαπεράω|διά+περάω
διαπονέομαι|διά+πονέομαι
διαπορεύομαι|διά+πορεύομαι
διαπορέω|διά+ἀπορέω
διαπραγματεύομαι|διά+πραγματεύομαι
διαπρίομαι|διά+πρίομαι
διαρπάζω|διά+ἁρπάζω
διαρρήγνυμι|διά+ῥήγνυμι
διασαφέω|διά+σαφής
διασείω|διά+σείω
διασκορπίζω|διά+σκορπίζω
διασπάω|διά+σπάω
διασπείρω|διά+σπείρω
διαστέλλομαι|διά+στέλλομαι
διαστρέφω|διά+στρέφω
διασῴζω|διά+σῴζω
διαταράσσω|διά+ταράσσω
διατάσσω|διά+τάσσω
διατελέω|διά+τελέω
διατηρέω|διά+τηρέω
διατίθεμαι|διά+τίθεμαι
διατρίβω|διά+τρίβω
διαυγάζω|διά+αὐγάζω
διαφέρω|διά+φέρω
διαφεύγω|διά+φεύγω
διαφημίζω|διά+φημίζω
διαφθείρω|διά+φθείρω
διαφυλάσσω|διά+φυλάσσω
διαχειρίζομαι|διά+χειρίζομαι
διαχλευάζω|διά+χλευάζω
διαχωρίζομαι|διά+χωρίζομαι
διεγείρω|διά+ἐγείρω
διενθυμέομαι|διά+ἐν+θυμέομαι
διερμηνεύω|διά+ἑρμηνεύω
διέρχομαι|διά+ἔρχομαι
διερωτάω|διά+ἐρωτάω
διηγέομαι|διά+ἡγέομαι
διϊκνέομαι|διά+ἱκνέομαι
διΐστημι|διά+ἵστημι
διϊσχυρίζομαι|διά+ἰσχυρίζομαι
διοδεύω|διά+ὁδεύω
διορύσσω|διά+ὀρύσσω
διϋλίζω|διά+ὑλίζω
εἰσάγω|εἰς+ἄγω
εἰσακούω|εἰς+ἀκούω
εἰσδέχομαι|εἰς+δέχομαι
εἴσειμι|εἰς+εἶμι
εἰσέρχομαι|εἰς+ἔρχομαι
εἰσκαλέομαι|εἰς+καλέομαι
εἰσπηδάω|εἰς+πηδάω
εἰσπορεύομαι|εἰς+πορεύομαι
εἰστρέχω|εἰς+τρέχω
εἰσφέρω|εἰς+φέρω
ἐγκαταλείπω|ἐκ+κατά+λείπω
ἐκβαίνω|ἐκ+βαίνω
ἐκβάλλω|ἐκ+βάλλω
ἐκδαπανάομαι|ἐκ+δαπανάω
ἐκδέχομαι|ἐκ+δέχομαι
ἐκδημέω|ἐκ+δημέω
ἐκδίδωμι|ἐκ+δίδωμι
ἐκδιηγέομαι|ἐκ+διά+ἡγέομαι
ἐκδικέω|ἐκ+δικέω
ἐκδιώκω|ἐκ+διώκω
ἐκδύω|ἐκ+δύω
ἐκζητέω|ἐκ+ζητέω
ἐκθαμβέομαι|ἐκ+θαμβέομαι
ἐκθαυμάζω|ἐκ+θαυμάζω
ἐκκαθαίρω|ἐκ+καθαίρω
ἐκκαίομαι|ἐκ+καίομαι
ἐκκεντέω|ἐκ+κεντέω
ἐκκλάω|ἐκ+κλάω
ἐκκλείω|ἐκ+κλείω
ἐκκλίνω|ἐκ+κλίνω
ἐκκολυμβάω|ἐκ+κολυμβάω
ἐκκομίζω|ἐκ+κομέω
ἐκκόπτω|ἐκ+κόπτω
ἐκκρέμαμαι|ἐκ+κρέμαμαι
ἐκλαλέω|ἐκ+λαλέω
ἐκλάμπω|ἐκ+λάμπω
ἐκλανθάνω|ἐκ+λανθάνω
ἐκλέγομαι|ἐκ+λέγομαι
ἐκλείπω|ἐκ+λείπω
ἐκλύομαι|ἐκ+λύομαι
ἐκμάσσω|ἐκ+μάσσω
ἐκμυκτηρίζω|ἐκ+μυκτηρίζω
ἐκνεύω|ἐκ+νεύω
ἐκνήφω|ἐκ+νήφω
ἐκπειράζω|ἐκ+πειράζω
ἐκπέμπω|ἐκ+πέμπω
ἐκπετάννυμι|ἐκ+πετάννυμι
ἐκπηδάω|ἐκ+πηδάω
ἐκπίπτω|ἐκ+πίπτω
ἐκπλέω|ἐκ+πλέω
ἐκπληρόω|ἐκ+πληρόω
ἐκπλήσσομαι|ἐκ+πλήσσομαι
ἐκπνέω|ἐκ+πνέω
ἐκπορεύομαι|ἐκ+πορεύομαι
ἐκπορνεύω|ἐκ+πορνεύω
ἐκπτύω|ἐκ+πτύω
ἐκριζόω|ἐκ+ῥίζα
ἐκστρέφομαι|ἐκ+στρέφομαι
ἐκταράσσω|ἐκ+ταράσσω
ἐκτείνω|ἐκ+τείνω
ἐκτελέω|ἐκ+τελέω
ἐκτίθημι|ἐκ+τίθημι
ἐκτινάσσω|ἐκ+τινάσσω
ἐκτρέπομαι|ἐκ+τρέπομαι
ἐκτρέφω|ἐκ+τρέφω
ἐκφέρω|ἐκ+φέρω
ἐκφεύγω|ἐκ+φεύγω
ἐκφοβέω|ἐκ+φοβέω
ἐκφύω|ἐκ+φύω
ἐκχέω|ἐκ+χέω
ἐκχωρέω|ἐκ+χωρέω
ἐκψύχω|ἐκ+ψύχω
ἐξαγγέλλω|ἐκ+ἀγγέλλω
ἐξαγοράζω|ἐκ+ἀγοράζω
ἐξάγω|ἐκ+ἄγω
ἐξαιρέω|ἐκ+αἱρέω
ἐξαίρω|ἐκ+αἴρω
ἐξαιτέομαι|ἐκ+αἰτέω
ἐξακολουθέω|ἐκ+ἀκολουθέω
ἐξαλείφω|ἐκ+ἀλείφω
ἐξάλλομαι|ἐκ+ἅλλομαι
ἐξανατέλλω|ἐκ+ἀνά+τέλλω
ἐξανίστημι|ἐκ+ἀνά+ἵστημι
ἐξαπατάω|ἐκ+ἀπατάω
ἐξαπορέομαι|ἐκ+ἀπορέω
ἐξαποστέλλω|ἐκ+ἀπό+στέλλω
ἐξαρτίζω|ἐκ+ἀρτίζω
ἐξαστράπτω|ἐκ+ἀστράπτω
ἐξεγείρω|ἐκ+ἐγείρω
ἔξειμι|ἐκ+εἰμί
ἐξέλκω|ἐκ+ἕλκω
ἐξεραυνάω|ἐκ+ἐραυνάω
ἐξέρχομαι|ἐκ+ἔρχομαι
ἔξεστι(ν)|ἐκ+ἔστι(ν)
ἐξετάζω|ἐκ+ἐτάζω
ἐξηγέομαι|ἐκ+ἡγέομαι
ἐξηχέομαι|ἐκ+ἠχέω
ἐξίστημι|ἐκ+ἵστημι
ἐξισχύω|ἐκ+ἴσχυω
ἐξολεθρεύω|ἐκ+ὀλεθρεύω
ἐξομολογέω|ἐκ+ὁμολογέω
ἐξορκίζω|ἐκ+ὁρκίζω
ἐξορύσσω|ἐκ+ὀρύσσω
ἐξουδενέω|ἐκ+οὐδενέω
ἐξουθενέω|ἐκ+οὐθενέω
ἐξουσιάζω|ἐκ+οὐσιάζω
ἐξυπνίζω|ἐκ+ὑπνίζω
ἐξωθέω|ἐκ+ὠθέω
ἐγγράφω|ἐν+γράφω
ἐγκαινίζω|ἐν+καινίζω
ἐγκακέω|ἐν+κακέω
ἐγκαλέω|ἐν+καλέω
ἐγκατοικέω|ἐν+κατά+οἰκέω
ἐγκαυχάομαι|ἐν+καυχάομαι
ἐγκεντρίζω|ἐν+κεντρίζω
ἐγκομβόομαι|ἐν+κομβόομαι
ἐγκόπτω|ἐν+κόπτω
ἐγκρατεύομαι|ἐν+κρατεύομαι
ἐγκρίνω|ἐν+κρίνω
ἐγκρύπτω|ἐν+κρύπτω
ἐγχρίω|ἐν+χρίω
ἐμβαίνω|ἐν+βαίνω
ἐμβάλλω|ἐν+βάλλω
ἐμβάπτω|ἐν+βάπτω
ἐμβατεύω|ἐν+βατεύω
ἐμβιβάζω|ἐν+βιβάζω
ἐμβλέπω|ἐν+βλέπω
ἐμβριμάομαι|ἐν+βριμάομαι
ἐμμαίνομαι|ἐν+μαίνομαι
ἐμμένω|ἐν+μένω
ἐμπαίζω|ἐν+παίξω
ἐμπεριπατέω|ἐν+περί+πατέω
ἐμπίμπλημι|ἐν+πίμπλημι
ἐμπίμπρημι|ἐν+πίμπρημι
ἐμπίπτω|ἐν+πίπτω
ἐμπλέκομαι|ἐν+πλέκομαι
ἐμπνέω|ἐν+πνέω
ἐμπορεύομαι|ἐν+πορεύομαι
ἐμπτύω|ἐν+πτύω
ἐμφανίζω|ἐν+φανίζω
ἐμφυσάω|ἐν+φυσάω
ἐναγκαλίζομαι|ἐν+ἀγκάλη
ἐνάρχομαι|ἐν+ἄρχομαι
ἐνδείκνυμι|ἐν+δείκνυμι
ἐνδέχεται|ἐν+δέχεται
ἐνδημέω|ἐν+δημέω
ἐνδιδύσκω|ἐν+διδύσκω
ἐνδοξάζομαι|ἐν+δοξάζομαι
ἐνδυναμόω|ἐν+δυναμόω
ἐνδύνω|ἐν+δύνω
ἐνδύω|ἐν+δύω
ἐνεδρεύω|ἐν+εδρεύω
ἐνειλέω|ἐν+εἰλέω
ἔνειμι|ἐν+εἰμί
ἐνεργέω|ἐν+ἔργον
ἐνευλογέω|ἐν+εὐλογέω
ἐνέχω|ἐν+ἔχω
ἐνθυμέομαι|ἐν+θυμός
ἐνίστημι|ἐν+ἵστημι
ἐνισχύω|ἐν+ἰσχύω
ἐννεύω|ἐν+νεύω
ἐνοικέω|ἐν+οἰκέω
ἐνορκίζω|ἐν+ὁρκίζω
ἐνοχλέω|ἐν+ὀχλέω
ἐνταφιάζω|ἐν+ταφιάζω
ἐντέλλομαι|ἐν+τέλλομαι
ἐντρέπω|ἐν+τρέπω
ἐντρέφομαι|ἐν+τρέφομαι
ἐντρυφάω|ἐν+τρυφάω
ἐντυγχάνω|ἐν+τυγχάνω
ἐντυλίσσω|ἐν+τυλίσσω
ἐντυπόω|ἐν+τύπος
ἐνυβρίζω|ἐν+ὑβρίζω
ἐνυπνιάζομαι|ἐν+ὑπνιάζομαι
ἐνωτίζομαι|ἐν+ὠτίζομαι
ἐπαγγέλλομαι|ἐπί+ἀγγέλλομαι
ἐπάγω|ἐπί+ἄγω
ἐπαγωνίζομαι|ἐπί+ἀγωνίζομαι
ἐπαθροίζομαι|ἐπί+ἀθροίζομαι
ἐπαινέω|ἐπί+αἰνέω
ἐπαίρω|ἐπί+αἴρω
ἐπαισχύνομαι|ἐπί+αἰσχύνομαι
ἐπαιτέω|ἐπί+αἰτέω
ἐπακολουθέω|ἐπί+ἀκολουθέω
ἐπακούω|ἐπί+ἀκούω
ἐπακροάομαι|ἐπί+ἀκροάομαι
ἐπανάγω|ἐπί+ἀνά+ἄγω
ἐπαναμιμνῄσκω|ἐπί+ἀνά+μιμνῄσκω
ἐπαναπαύομαι|ἐπί+ἀνά+παύω
ἐπανέρχομαι|ἐπί+ἀνά+ἔρχομαι
ἐπανίσταμαι|ἐπί+ἀνά+ἵσταμαι
ἐπαρκέω|ἐπί+ἀρκέω
ἐπαφρίζω|ἐπί+ἀφρίζω
ἐπεγείρω|ἐπί+ἐγείρω
ἔπειμι|ἐπί+εἶμι
ἐπεισέρχομαι|ἐπί+εἰς+ἔρχομαι
ἐπεκτείνομαι|ἐπί+ἐκ+τείνω
ἐπενδύομαι|ἐπί+ἐν+δύω
ἐπέρχομαι|ἐπί+ἔρχομαι
ἐπερωτάω|ἐπί+ἐρωτάω
ἐπέχω|ἐπί+ἐχω
ἐπιβαίνω|ἐπί+βαίνω
ἐπιβάλλω|ἐπί+βάλλω
ἐπιβαρέω|ἐπί+βάρος
ἐπιβιβάζω|ἐπί+βιβάζω
ἐπιβλέπω|ἐπί+βλέπω
ἐπιγαμβρεύω|ἐπί+γαμβρός
ἐπιγίνομαι|ἐπί+γίνομαι
ἐπιγινώσκω|ἐπί+γινώσκω
ἐπιγράφω|ἐπί+γράφω
ἐπιδείκνυμι|ἐπί+δείκνυμι
ἐπιδέχομαι|ἐπί+δέχομαι
ἐπιδημέω|ἐπί+δημέω
ἐπιδιατάσσομαι|ἐπί+διατάσσομαι
ἐπιδίδωμι|ἐπί+δίδωμι
ἐπιδιορθόω|ἐπί+διά+ὀρθόω
ἐπιδύω|ἐπί+δύω
ἐπιζητέω|ἐπί+ζητέω
ἐπιθυμέω|ἐπί+θυμέω
ἐπικαθίζω|ἐπί+κατά+ἵζω
ἐπικαλέω|ἐπί+καλέω
ἐπικαλύπτω|ἐπί+καλύπτω
ἐπίκειμαι|ἐπί+κεῖμαι
ἐπικέλλω|ἐπί+κέλλω
ἐπικρίνω|ἐπί+κρίνω
ἐπιλαμβάνομαι|ἐπί+λαμβάνομαι
ἐπιλανθάνομαι|ἐπί+λανθάνομαι
ἐπιλέγω|ἐπί+λέγω
ἐπιλείπω|ἐπί+λείπω
ἐπιλείχω|ἐπί+λείχω
ἐπιλύω|ἐπί+λύω
ἐπιμαρτυρέω|ἐπί+μαρτυρέω
ἐπιμελέομαι|ἐπί+μελέομαι
ἐπιμένω|ἐπί+μένω
ἐπινεύω|ἐπί+νεύω
ἐπιορκέω|ἐπί+ὁρκέω
ἐπιπίπτω|ἐπί+πίπτω
ἐπιπλήσσω|ἐπί+πλήσσω
ἐπιποθέω|ἐπί+ποθέω
ἐπιπορεύομαι|ἐπί+πορεύομαι
ἐπιράπτω|ἐπί+ῥάπτω
ἐπιρίπτω|ἐπί+ῥίπτω
ἐπισκέπτομαι|ἐπί+σκέπτομαι
ἐπισκευάζομαι|ἐπί+σκευάζομαι
ἐπισκηνόω|ἐπί+σκηνόω
ἐπισκιάζω|ἐπί+σκιάζω
ἐπισκοπέω|ἐπί+σκοπέω
ἐπισπάομαι|ἐπί+σπάομαι
ἐπισπείρω|ἐπί+σπείρω
ἐπίσταμαι|ἐπί+ἵσταμαι
ἐπιστέλλω|ἐπί+στέλλω
ἐπιστηρίζω|ἐπί+στηρίζω
ἐπιστομίζω|ἐπί+στόμα
ἐπιστρέφω|ἐπί+στρέφω
ἐπισυνάγω|ἐπί+σύν+ἄγω
ἐπισυντρέχω|ἐπί+σύν+τρέχω
ἐπισχύω|ἐπί+ἰσχύω
ἐπισωρεύω|ἐπί+σωρεύω
ἐπιτάσσω|ἐπί+τάσσω
ἐπιτελέω|ἐπί+τελέω
ἐπιτίθημι|ἐπί+τίθημι
ἐπιτιμάω|ἐπί+τιμάω
ἐπιτρέπω|ἐπί+τρέπω
ἐπιτυγχάνω|ἐπί+τυγχάνω
ἐπιφαίνω|ἐπί+φαίνω
ἐπιφαύσκω|ἐπί+φαυσκω
ἐπιφέρω|ἐπί+φέρω
ἐπιφωνέω|ἐπί+φωνέω
ἐπιφώσκω|ἐπί+φώσκω
ἐπιχειρέω|ἐπί+χείρ
ἐπιχέω|ἐπί+χέω
ἐπιχορηγέω|ἐπί+χορηγέω
ἐπιχρίω|ἐπί+χρίω
ἐποικοδομέω|ἐπί+οἰκοδομέω
ἐπονομάζομαι|ἐπί+ὀνομάζομαι
ἐποπτεύω|ἐπί+ὀπτεύω
ἐφάλλομαι|ἐπί+ἅλλομαι
ἐφικνέομαι|ἐπί+ἱκνέομαι
ἐφίστημι|ἐπί+ἵστημι
καθαιρέω|κατά+αἱρέω
καθάπτω|κατά+ἅπτω
καθέζομαι|κατά+ἕζομαι
καθεύδω|κατά+εὕδω
καθήκω|κατά+ἥκω
κάθημαι|κατά+ἧμαι
καθίζω|κατά+ἵζω
καθίημι|κατά+ἵημι
καθίστημι|κατά+ἵστημι
καθοπλίζω|κατά+ὁπλίζω
καθοράω|κατά+ὁράω
καμμύω|κατά+μύω
καταβαίνω|κατά+βαίνω
καταβάλλω|κατά+βάλλω
καταβαρέω|κατά+βαρέω
καταβαρύνομαι|κατά+βαρύνομαι
καταβραβεύω|κατά+βραβεύω
καταγγέλλω|κατά+ἀγγέλλω
καταγελάω|κατά+γελάω
καταγινώσκω|κατά+γινώσκω
κατάγνυμι|κατά+ἄγνυμι
κατάγω|κατά+ἄγω
καταγωνίζομαι|κατά+ἀγωνίζομαι
καταδέω|κατά+δέω
καταδικάζω|κατά+δικάζω
καταδιώκω|κατά+διώκω
καταδουλόω|κατά+δουλόω
καταδυναστεύω|κατά+δυναστεύω
καταθεματίζω|κατά+θεματίζω
καταισχύνω|κατά+αἰσχύνω
κατακαίω|κατά+καίω
κατακαλύπτομαι|κατά+καλύπτομαι
κατακαυχάομαι|κατά+καυχάομαι
κατάκειμαι|κατά+κεῖμαι
κατακλάω|κατά+κλάω
κατακλείω|κατά+κλείω
κατακληρονομέω|κατά+κληρονομέω
κατακλίνω|κατά+κλίνω
κατακλύζω|κατά+κλύζω
κατακολουθέω|κατά+ἀκολουθέω
κατακόπτω|κατά+κόπτω
κατακρημνίζω|κατά+κρημνός
κατακρίνω|κατά+κρίνω
κατακυριεύω|κατά+κυριεύω
καταλαλέω|κατά+λαλέω
καταλαμβάνω|κατά+λαμβάνω
καταλέγω|κατά+λέγω
καταλείπω|κατά+λείπω
καταλιθάζω|κατά+λιθάζω
καταλλάσσω|κατά+ἀλλάσσω
καταλύω|κατά+λύω
καταμανθάνω|κατά+μανθάνω
καταμαρτυρέω|κατά+μαρτυρέω
καταμένω|κατά+μένω
καταναλίσκω|κατά+ἀνά+ἁλίσκω
καταναρκάω|κατά+ναρκάω
κατανεύω|κατά+νεύω
κατανοέω|κατά+νοέω
καταντάω|κατά+ἀντάω
κατανύσσομαι|κατά+νύσσομαι
καταξιόω|κατά+ἀξιόω
καταπατέω|κατά+πατέω
καταπαύω|κατά+παύω
καταπίνω|κατά+πίνω
καταπίπτω|κατά+πίπτω
καταπλέω|κατά+πλέω
καταπονέω|κατά+πονέω
καταποντίζομαι|κατά+ποντίζομαι
καταράομαι|κατά+ἀράομαι
καταργέω|κατά+ἀργέω
καταριθμέω|κατά+ἀριθμέω
καταρτίζω|κατά+ἀρτίζω
κατασείω|κατά+σείω
κατασκάπτω|κατά+σκάπτω
κατασκευάζω|κατά+σκευάζω
κατασκηνόω|κατά+σκηνόω
κατασκιάζω|κατά+σκιάζω
κατασκοπέω|κατά+σκοπέω
κατασοφίζομαι|κατά+σοφίζομαι
καταστέλλω|κατά+στέλλω
καταστρέφω|κατά+στρέφω
καταστρηνιάω|κατά+στρηνιάω
καταστρώννυμι|κατά+στρωννύω
κατασύρω|κατά+σύρω
κατασφάζω|κατά+σφάζω
κατασφραγίζω|κατά+σφραγίζω
κατατίθημι|κατά+τίθημι
κατατρέχω|κατά+τρέχω
καταφέρω|κατά+φέρω
καταφεύγω|κατά+φεύγω
καταφθείρω|κατά+φθείρω
καταφιλέω|κατά+φιλέω
καταφρονέω|κατά+φρονέω
καταχέω|κατά+χέω
καταχράομαι|κατά+χράομαι
καταψύχω|κατά+ψύχω
κατεξουσιάζω|κατά+ἐξουσιάζω
κατεργάζομαι|κατά+ἐργάζομαι
κατέρχομαι|κατά+ἔρχομαι
κατεσθίω|κατά+ἐσθίω
κατευθύνω|κατά+εὐθύνω
κατευλογέω|κατά+εὐλογέω
κατεφίστημι|κατά+ἐπί+ἵστημι
κατέχω|κατά+ἔχω
κατηγορέω|κατά+ἀγορεύω
κατηχέω|κατά+ἠχέω
κατιόομαι|κατά+ἰόομα
κατισχύω|κατά+ἰσχύω
κατοικέω|κατά+οἰκέω
κατοικίζω|κατά+οἰκίζω
κατοπτρίζομαι|κατά+οπτρίζομαι
μεθερμηνεύω|μετά+ἑρμηνεύω
μεθίστημι|μετά+ἵστημι
μεταβαίνω|μετά+βαίνω
μεταβάλλομαι|μετά+βάλλομαι
μετάγω|μετά+ἄγω
μεταδίδωμι|μετά+δίδωμι
μεταίρω|μετά+αἴρω
μετακαλέομαι|μετά+καλέομαι
μετακινέω|μετά+κινέω
μεταλαμβάνω|μετά+λαμβάνω
μεταλλάσσω|μετά+ἀλλάσσω
μεταμέλομαι|μετά+μέλω
μεταμορφόομαι|μετά+μορφόομαι
μετανοέω|μετά+νοέω
μεταπέμπομαι|μετά+πέμπομαι
μεταστρέφω|μετά+στρέφω
μετασχηματίζω|μετά+σχηματίζω
μετατίθημι|μετά+τίθημι
μετατρέπω|μετά+τρέπω
μετέχω|μετά+ἔχω
μετοικίζω|μετά+οἰκίζω
παραβαίνω|παρά+βαίνω
παραβάλλω|παρά+βάλλω
παραβιάζομαι|παρά+βιάζω
παραβολεύομαι|παρά+βουλεύω
παραγγέλλω|παρά+ἀγγέλλω
παραγίνομαι|παρά+γίνομαι
παράγω|παρά+ἄγω
παραδειγματίζω|παρά+δειγματίζω
παραδέχομαι|παρά+δέχομαι
παραδίδωμι|παρά+δίδωμι
παραζηλόω|παρά+ζηλόω
παραθεωρέω|παρά+θεωρέω
παραινέω|παρά+αἰνέω
παραιτέομαι|παρά+αἰτέω
παρακαθέζομαι|παρά+κατά+ἕζομαι
παρακαλέω|παρά+καλέω
παρακαλύπτομαι|παρά+καλύπτομαι
παράκειμαι|παρά+κεῖμαι
παρακολουθέω|παρά+ἀκολουθέω
παρακούω|παρά+ἀκούω
παρακύπτω|παρά+κύπτω
παραλαμβάνω|παρά+λαμβάνω
παραλέγομαι|παρά+λέγομαι
παραλογίζομαι|παρά+λογίζομαι
παραλύομαι|παρά+λύομαι
παραμένω|παρά+μένω
παραμυθέομαι|παρά+μῦθος
παρανομέω|παρά+νόμος
παραπικραίνω|παρά+πικραίνω
παραπίπτω|παρά+πίπτω
παραπλέω|παρά+πλέω
παραπορεύομαι|παρά+πορεύομαι
παραρρέω|παρά+ῥέω
παρασκευάζω|παρά+σκευάζω
παρατείνω|παρά+τείνω
παρατηρέω|παρά+τηρέω
παρατίθημι|παρά+τίθημι
παρατυγχάνω|παρά+τυγχάνω
παραφέρω|παρά+φέρω
παραφρονέω|παρά+φρονέω
παραχειμάζω|παρά+χεῖμα
παρεδρεύω|παρά+ἑδραῖος
πάρειμι|παρά+εἰμί
παρεισάγω|παρά+εἰς+ἄγω
παρεισδύω|παρά+εἰς+δύω
παρεισέρχομαι|παρά+εἰς+ἔρχομαι
παρεισφέρω|παρά+εἰς+φέρω
παρεμβάλλω|παρά+ἐν+βάλλω
παρενοχλέω|παρά+ἐν+ὀχλέω
παρέρχομαι|παρά+ἔρχομαι
παρέχω|παρά+ἔχω
παρίημι|παρά+ἵημι
παροικέω|παρά+οἰκέω
παροίχομαι|παρά+οἴχομαι
παρομοιάζω|παρά+ὁμοιάζω
παροξύνομαι|παρά+ὀξύνομαι
παροργίζω|παρά+ὀργίζω
παροτρύνω|παρά+ὀτρύνω
περιάγω|περί+ἀγω
περιαιρέω|περί+αἱρέω
περιάπτω|περί+ἅπτω
περιαστράπτω|περί+ἀστράπτω
περιβάλλω|περί+βάλλω
περιβλέπομαι|περί+βλέπομαι
περιδέω|περί+δέω
περιεργάζομαι|περί+ἐργάζομαι
περιέρχομαι|περί+ἔρχομαι
περιέχω|περί+ἔχω
περιζώννυμι|περί+ζώννυμι
περιΐστημι|περί+ἵστημι
περικαλύπτω|περί+καλύπτω
περίκειμαι|περί+κεῖμαι
περικρύβω|περί+κρύβω
περικυκλόω|περί+κυκλόω
περιλάμπω|περί+λάμπω
περιλείπομαι|περί+λείπω
περιμένω|περί+μένω
περιοικέω|περί+οἰκέω
περιπατέω|περί+πατέω
περιπείρω|περί+πείρω
περιπίπτω|περί+πίπτω
περιποιέομαι|περί+ποιέομαι
περιρήγνυμι|περί+ῥήγνυμι
περισπάομαι|περί+σπάομαι
περιτέμνω|περί+τέμνω
περιτίθημι|περί+τίθημι
περιτρέπω|περί+τρέπω
περιτρέχω|περί+τρέχω
περιφέρω|περί+φέρω
περιφρονέω|περί+φρονέω
προάγω|πρό+ἄγω
προαιρέομαι|πρό+αἱρέομαι
προαιτιάομαι|πρό+αἰτιάομαι
προακούω|πρό+ἀκούω
προαμαρτάνω|πρό+ἁμαρτάνω
προβαίνω|πρό+βαίνω
προβάλλω|πρό+βάλλω
προβιβάζω|πρό+βαίνω
προβλέπομαι|πρό+βλέπομαι
προγίνομαι|πρό+γίνομαι
προγινώσκω|πρό+γινώσκω
προγράφω|πρό+γράφω
προδίδωμι|πρό+δίδωμι
προελπίζω|πρό+ἐλπίζω
προενάρχομαι|πρό+ἐν+ἄρχομαι
προεπαγγέλλομαι|πρό+ἐπί+ἀγγέλλομαι
προέρχομαι|πρό+ἔρχομαι
προετοιμάζω|πρό+ἑτοιμάζω
προευαγγελίζομαι|πρό+εὐαγγελίζομαι
προέχομαι|πρό+ἔχομαι
προηγέομαι|πρό+ἡγέομαι
προΐστημι|πρό+ἵστημι
προκαλέομαι|πρό+καλέομαι
προκαταγγέλλω|πρό+κατά+ἀγγέλλω
προκαταρτίζω|πρό+κατά+ἀρτίζω
πρόκειμαι|πρό+κεῖμαι
προκηρύσσω|πρό+κηρύσσω
προκόπτω|πρό+κόπτω
προκυρόω|πρό+κυρόω
προλαμβάνω|πρό+λαμβάνω
προλέγω|πρό+λέγω
προμαρτύρομαι|πρό+μαρτύρομαι
προμελετάω|πρό+μελετάω
προμεριμνάω|πρό+μεριμνάω
προνοέω|πρό+νοέω
προοράω|πρό+ὁράω
προορίζω|πρό+ὁρίζω
προπάσχω|πρό+πάσχω
προπέμπω|πρό+πέμπω
προπορεύομαι|πρό+πορεύομαι
προτείνω|πρό+τείνω
προτίθεμαι|πρό+τίθεμαι
προτρέπομαι|πρό+τρέπομαι
προτρέχω|πρό+τρέχω
προϋπάρχω|πρό+ὑπό+ἄρχω
προφέρω|πρό+φέρω
προφθάνω|πρό+φθάνω
προχειρίζομαι|πρό+χειρίζομαι
προχειροτονέω|πρό+χειροτονέω
φρουρέω|πρό+οὐρέω
προσαγορεύω|πρός+ἀγορεύω
προσάγω|πρός+ἄγω
προσαιτέω|πρός+αἰτέω
προσαναβαίνω|πρός+ἀνά+βαίνω
προσαναλίσκω|πρός+ἀνά+ἁλίσκω
προσαναπληρόω|πρός+ἀνά+πληρόω
προσανατίθημι|πρός+ἀνά+τίθημι
προσαπειλέομαι|πρός+ἀπειλέομαι
προσδαπανάω|πρός+δαπανάω
προσδέομαι|πρός+δέομαι
προσδέχομαι|πρός+δέχομαι
προσδοκάω|πρός+δοκάω
προσεάω|πρός+ἐάω
προσεργάζομαι|πρός+ἐργάζομαι
προσέρχομαι|πρός+ἔρχομαι
προσεύχομαι|πρός+εὐχή
προσέχω|πρός+ἔχω
προσηλόω|πρός+ἡλόω
προσκαλέομαι|πρός+καλέομαι
προσκαρτερέω|πρός+καρτερέω
προσκληρόομαι|πρός+κληρόομαι
προσκλίνομαι|πρός+κλίνομαι
προσκολλάομαι|πρός+κολλάομαι
προσκόπτω|πρός+κόπτω
προσκυλίω|πρός+κυλίω
προσκυνέω|πρός+κυνέω
προσλαλέω|πρός+λαλέω
προσλαμβάνομαι|πρός+λαμβάνομαι
προσμένω|πρός+μένω
προσορμίζομαι|πρός+ὁρμίζομαι
προσοφείλω|πρός+ὀφείλω
προσοχθίζω|πρός+ὀχθίζω
προσπήγνυμι|πρός+πήγνυμι
προσπίπτω|πρός+πίπτω
προσποιέομαι|πρός+ποιέομαι
προσπορεύομαι|πρός+πορεύομαι
προστάσσω|πρός+τάσσω
προστίθημι|πρός+τίθημι
προστρέχω|πρός+τρέχω
προσφέρω|πρός+φέρω
προσφωνέω|πρός+φωνή
προσψαύω|πρός+ψαύω
συγκάθημαι|σύν+κατά+ἧμαι
συγκαθίζω|σύν+κατά+ἵζω
συγκακοπαθέω|σύν+κακοπαθέω
συγκακουχέομαι|σύν+κακουχέω
συγκαλέω|σύν+καλέω
συγκαλύπτω|σύν+καλύπτω
συγκάμπτω|σύν+κάμπτω
συγκαταβαίνω|σύν+κατά+βαίνω
συγκατατίθεμαι|σύν+κατά+τίθεμαι
συγκαταψηφίζομαι|σύν+κατά+ψηφίζομαι
συγκεράννυμι|σύν+κεράννυμι
συγκινέω|σύν+κινέω
συγκλείω|σύν+κλείω
συγκοινωνέω|σύν+κοινωνέω
συγκομίζω|σύν+κομίζω
συγκρίνω|σύν+κρίνω
συγκύπτω|σύν+κύπτω
συγχαίρω|σύν+χαίρω
συγχέω|σύν+χέω
συγχράομαι|σύν+χράομαι
συζάω|σύν+ζάω
συζεύγνυμι|σύν+ζεύγνυμι
συζητέω|σύν+ζητέω
συζωοποιέω|σύν+ζωοποιέω
συλλαλέω|σύν+λαλέω
συλλαμβάνω|σύν+λαμβάνω
συλλέγω|σύν+λέγω
συλλογίζομαι|σύν+λογίζομαι
συλλυπέομαι|σύν+λυπέομαι
συμβαίνω|σύν+βαίνω
συμβάλλω|σύν+βάλλω
συμβασιλεύω|σύν+βασιλεύω
συμβιβάζω|σύν+βιβάζω
συμβουλεύω|σύν+βουλεύω
συμμαρτυρέω|σύν+μαρτυρέω
συμμερίζομαι|σύν+μερίζομαι
συμμορφίζομαι|σύν+μορφίζομαι
συμπαθέω|σύν+παθέω
συμπαραγίνομαι|σύν+παρά+γίνομαι
συμπαρακαλέομαι|σύν+παρά+καλέω
συμπαραλαμβάνω|σύν+παρά+λαμβάνω
συμπάρειμι|σύν+παρά+εἰμί
συμπάσχω|σύν+πάσχω
συμπέμπω|σύν+πέμπω
συμπεριλαμβάνω|σύν+περιλαμβάνω
συμπίνω|σύν+πίνω
συμπίπτω|σύν+πίπτω
συμπληρόω|σύν+πληρόω
συμπνίγω|σύν+πνίγω
συμπορεύομαι|σύν+πορεύομαι
συμφέρω|σύν+φέρω
σύμφημι|σύν+φημί
συμφύομαι|σύν+φύομαι
συμφωνέω|σύν+φωνέω
συμψηφίζω|σύν+ψηφίζω
συνάγω|σύν+ἄγω
συναγωνίζομαι|σύν+ἀγωνίζομαι
συναθλέω|σύν+ἀθλέω
συναθροίζω|σύν+ἀθροίζω
συναίρω|σύν+αἴρω
συνακολουθέω|σύν+ἀκολουθέω
συναλίζομαι|σύν+ἁλίζομαι
συναλλάσσω|σύν+ἀλλάσσω
συναναβαίνω|σύν+ἀνά+βαίνω
συνανάκειμαι|σύν+ἀνά+κεῖμαι
συναναπαύομαι|σύν+ἀνά+παύω
συναντάω|σύν+ἀντάω
συναντιλαμβάνομαι|σύν+ἀντί+λαμβάνομαι
συναπάγομαι|σύν+ἀπάγομαι
συναποθνῄσκω|σύν+ἀπό+θνῄσκω
συναπόλλυμαι|σύν+ἀπό+ὄλλυμαι
συναποστέλλω|σύν+ἀπό+στέλλω
συναρμολογέομαι|σύν+ἁρμολογέομαι
συναρπάζω|σύν+ἁρπάζω
συναυξάνομαι|σύν+αὐξάνομαι
συνδέομαι|σύν+δέομαι
συνδοξάζομαι|σύν+δοξάζομαι
συνεγείρω|σύν+ἐγείρω
σύνειμι|σύν+εἰμί;σύν+εἶμι
συνεισέρχομαι|σύν+εἰς+ἔρχομαι
συνεπιμαρτυρέω|σύν+ἐπί+μαρτυρέω
συνεπιτίθεμαι|σύν+ἐπί+τίθεμαι
συνέπομαι|σύν+ἕπομαι
συνεργέω|σύν+εργέω
συνέρχομαι|σύν+ἔρχομαι
συνεσθίω|σύν+ἐσθίω
συνευδοκέω|σύν+εὐδοκέω
συνευωχέομαι|σύν+εὐωχέομαι
συνεφίστημι|σύν+ἐπί+ἵστημι
συνέχω|σύν+ἔχω
συνήδομαι|σύν+ἥδομαι
συνθάπτομαι|σύν+θάπτομαι
συνθλάομαι|σύν+θλάομαι
συνθλίβω|σύν+θλίβω
συνθρύπτω|σύν+θρύπτω
συνίημι|σύν+ἵημι
συνίστημι|σύν+ἵστημι
συνοδεύω|σύν+ὁδεύω
σύνοιδα|σύν+οἶδα
συνοικέω|σύν+οἰκέω
συνοικοδομέω|σύν+οἰκοδομέω
συνομορέω|σύν+ὅμορέω
συνοράω|σύν+ὁράω
συντάσσω|σύν+τάσσω
συντελέω|σύν+τελέω
συντέμνω|σύν+τέμνω
συντηρέω|σύν+τηρέω
συντίθεμαι|σύν+τίθεμαι
συντρέχω|σύν+τρέχω
συντρίβω|σύν+τρίβω
συντυγχάνω|σύν+τυγχάνω
συνυποκρίνομαι|σύν+ὑπό+κρίνομαι
συνυπουργέω|σύν+ὑπουργέω
συνωδίνω|σύν+ὠδίνω
συσπαράσσω|σύν+σπαράσσω
συσταυρόομαι|σύν+σταυρόομαι
συστέλλω|σύν+στέλλω
συστενάζω|σύν+στενάζω
συστοιχέω|σύν+στοιχέω
συστρέφω|σύν+στρέφω
συσχηματίζομαι|σύν+σχηματίζομαι
ὑπεραίρομαι|ὑπέρ+αἴρομαι
ὑπεραυξάνω|ὑπέρ+αὐξάνω
ὑπερβάλλω|ὑπέρ+βάλλω
ὑπερεκτείνω|ὑπέρ+ἐκ+τείνω
ὑπερεκχύννομαι|ὑπέρ+ἐκ+χύννομαι
ὑπερεντυγχάνω|ὑπέρ+ἐν+τυγχάνω
ὑπερέχω|ὑπέρ+ἔχω
ὑπερνικάω|ὑπέρ+νικάω
ὑπεροράω|ὑπέρ+ὁράω
ὑπερπερισσεύω|ὑπέρ+περισσεύω
ὑπερπλεονάζω|ὑπέρ+πλεονάζω
ὑπερυψόω|ὑπέρ+ὑψόω
ὑπερφρονέω|ὑπέρ+φρονέω
ὑπάγω|ὑπό+ἄγω
ὑπακούω|ὑπό+ἀκούω
ὑπαντάω|ὑπό+ἄντα
ὑπάρχω|ὑπό+ἄρχω
ὑπείκω|ὑπό+εἴκω
ὑπέχω|ὑπό+ἔχω
ὑποβάλλω|ὑπό+βάλλω
ὑποδείκνυμι|ὑπό+δεικνύμι
ὑποδέομαι|ὑπό+δέομαι
ὑποδέχομαι|ὑπό+δέχομαι
ὑποζώννυμι|ὑπό+ζώννυμι
ὑποκρίνομαι|ὑπό+κρίνω
ὑπολαμβάνω|ὑπό+λαμβάνω
ὑπολείπω|ὑπό+λείπω
ὑπολιμπάνω|ὑπό+λιμπάνω
ὑπομένω|ὑπό+μένω
ὑπομιμνῄσκω|ὑπό+μιμνῄσκω
ὑπονοέω|ὑπό+νοέω
ὑποπλέω|ὑπό+πλέω
ὑποπνέω|ὑπό+πνέω
ὑποστέλλω|ὑπό+στέλλω
ὑποστρέφω|ὑπό+στρέφω
ὑποστρωννύω|ὑπό+στρωννύω
ὑποτάσσω|ὑπό+τάσσω
ὑποτίθημι|ὑπό+τίθημι
ὑποτρέχω|ὑπό+τρέχω
ὑποφέρω|ὑπό+φέρω
ὑποχωρέω|ὑπό+χωρέω
